LEV0MAP header: field/width=13, block/height=288, decoded=3744
first 8 WRONG direct rows:
  [1, 1, 1, 1, 1, 1, 1, 1, 1, 1, 1, 1, 1]
  [1, 126, 201, 138, 184, 179, 157, 156, 155, 134, 133, 132, 215]
  [215, 201, 197, 123, 1, 1, 1, 1, 1, 1, 1, 227, 1]
  [1, 1, 11, 2, 10, 86, 83, 2, 2, 2, 95, 93, 86]
  [83, 95, 2, 83, 95, 93, 26, 4, 4, 4, 4, 4, 23]
  [92, 90, 102, 99, 231, 231, 86, 83, 2, 21, 24, 21, 24]
  [2, 95, 93, 126, 125, 134, 133, 132, 131, 66, 57, 67, 58]
  [68, 59, 225, 185, 184, 182, 182, 182, 179, 184, 182, 179, 182]
first 8 CORRECT type4 rows:
  [1, 1, 1, 1, 1, 1, 1, 1, 1, 1, 1, 1, 1]
  [1, 1, 1, 1, 1, 1, 1, 1, 1, 1, 1, 1, 1]
  [1, 1, 1, 1, 1, 1, 1, 1, 1, 1, 1, 1, 1]
  [1, 1, 1, 1, 1, 1, 1, 1, 1, 1, 1, 1, 1]
  [1, 1, 1, 1, 1, 1, 1, 1, 1, 1, 1, 1, 1]
  [1, 1, 1, 1, 1, 1, 1, 1, 1, 1, 1, 1, 1]
  [1, 1, 1, 1, 1, 1, 1, 1, 1, 1, 1, 1, 1]
  [1, 1, 1, 1, 1, 1, 1, 1, 1, 1, 1, 1, 1]

LEV1MAP header: field/width=13, block/height=288, decoded=3744
first 8 WRONG direct rows:
  [0, 1, 1, 1, 1, 1, 1, 1, 1, 1, 1, 1, 1]
  [1, 176, 175, 1, 173, 174, 1, 74, 96, 14, 83, 6, 5]
  [3, 5, 80, 200, 82, 5, 3, 5, 6, 81, 123, 135, 120]
  [1, 67, 1, 67, 1, 1, 163, 147, 90, 117, 163, 147, 129]
  [132, 1, 1, 26, 44, 23, 181, 75, 192, 44, 72, 1, 181]
  [1, 1, 1, 1, 1, 1, 1, 1, 1, 1, 1, 1, 1]
  [1, 163, 147, 43, 147, 85, 151, 132, 1, 1, 1, 1, 1]
  [1, 1, 1, 1, 1, 1, 1, 1, 195, 75, 96, 134, 119]
first 8 CORRECT type4 rows:
  [0, 4, 7, 38, 39, 40, 41, 108, 109, 172, 177, 201, 1]
  [1, 1, 1, 1, 1, 1, 1, 1, 1, 1, 1, 1, 1]
  [1, 1, 1, 1, 1, 1, 1, 1, 1, 1, 1, 1, 1]
  [1, 1, 1, 1, 1, 1, 1, 1, 1, 1, 1, 1, 1]
  [1, 1, 1, 1, 1, 1, 1, 1, 1, 1, 1, 1, 1]
  [1, 1, 1, 1, 1, 1, 1, 1, 1, 1, 1, 1, 1]
  [1, 1, 1, 1, 1, 1, 1, 1, 1, 1, 1, 1, 1]
  [1, 1, 1, 1, 1, 1, 1, 1, 1, 1, 1, 1, 1]

LEV2MAP header: field/width=13, block/height=288, decoded=3744
first 8 WRONG direct rows:
  [0, 1, 1, 1, 1, 1, 1, 1, 1, 1, 1, 1, 1]
  [1, 11, 8, 4, 2, 12, 36, 34, 32, 167, 198, 198, 198]
  [198, 198, 198, 41, 168, 170, 45, 24, 25, 85, 83, 1, 1]
  [1, 1, 1, 1, 171, 36, 34, 32, 165, 43, 40, 161, 109]
  [107, 169, 1, 1, 1, 1, 1, 133, 134, 136, 138, 124, 1]
  [171, 117, 115, 199, 117, 115, 199, 175, 175, 169, 10, 6, 171]
  [199, 175, 199, 199, 165, 49, 47, 66, 61, 59, 66, 49, 47]
  [68, 121, 163, 169, 1, 171, 165, 69, 48, 46, 69, 161, 169]
first 8 CORRECT type4 rows:
  [0, 1, 1, 1, 1, 1, 1, 1, 1, 1, 1, 1, 1]
  [1, 1, 1, 1, 1, 1, 1, 1, 1, 1, 1, 1, 1]
  [1, 1, 1, 1, 1, 1, 1, 1, 1, 1, 1, 1, 1]
  [1, 1, 1, 1, 1, 1, 1, 1, 1, 1, 1, 1, 1]
  [1, 1, 1, 1, 1, 1, 1, 1, 1, 1, 1, 1, 1]
  [1, 1, 1, 1, 1, 1, 1, 1, 1, 1, 1, 1, 1]
  [1, 1, 1, 1, 1, 1, 1, 1, 1, 1, 1, 1, 1]
  [1, 1, 1, 1, 1, 1, 1, 1, 1, 1, 1, 1, 1]

LEV3MAP header: field/width=13, block/height=288, decoded=3744
first 8 WRONG direct rows:
  [0, 1, 1, 1, 1, 1, 1, 1, 1, 1, 1, 1, 1]
  [1, 99, 50, 49, 100, 1, 1, 1, 1, 1, 1, 1, 1]
  [1, 1, 1, 1, 1, 1, 1, 1, 205, 201, 202, 84, 83]
  [84, 83, 198, 42, 41, 24, 35, 33, 32, 31, 30, 29, 27]
  [25, 23, 21, 37, 151, 155, 155, 156, 156, 155, 157, 157, 157]
  [146, 145, 157, 157, 157, 150, 216, 151, 157, 142, 141, 142, 141]
  [157, 156, 157, 146, 145, 157, 157, 157, 146, 145, 157, 157, 142]
  [141, 157, 150, 199, 125, 123, 121, 119, 199, 125, 123, 121, 119]
first 8 CORRECT type4 rows:
  [0, 77, 78, 214, 223, 229, 1, 1, 1, 1, 1, 1, 1]
  [1, 1, 1, 1, 1, 1, 1, 1, 1, 1, 1, 1, 1]
  [1, 1, 1, 1, 1, 1, 1, 1, 1, 1, 1, 1, 1]
  [1, 1, 1, 1, 1, 1, 1, 1, 1, 1, 1, 1, 1]
  [1, 1, 1, 1, 1, 1, 1, 1, 1, 1, 1, 1, 1]
  [1, 1, 1, 1, 1, 1, 1, 1, 1, 1, 1, 1, 1]
  [1, 1, 1, 1, 1, 1, 1, 1, 1, 1, 1, 1, 1]
  [1, 1, 1, 1, 1, 1, 1, 1, 1, 1, 1, 1, 1]

LEV4MAP header: field/width=13, block/height=288, decoded=3744
first 8 WRONG direct rows:
  [0, 1, 1, 1, 1, 1, 1, 1, 1, 1, 1, 1, 1]
  [1, 163, 45, 46, 47, 47, 48, 113, 1, 1, 1, 75, 103]
  [77, 179, 77, 103, 73, 168, 153, 201, 38, 201, 38, 135, 120]
  [116, 26, 106, 76, 107, 24, 163, 147, 90, 117, 176, 91, 174]
  [1, 176, 91, 174, 27, 181, 1, 181, 19, 75, 77, 73, 1]
  [1, 1, 215, 215, 215, 215, 215, 176, 175, 92, 97, 84, 1]
  [26, 36, 33, 30, 24, 176, 159, 156, 175, 176, 175, 176, 175]
  [176, 175, 25, 36, 33, 30, 106, 72, 1, 74, 72, 1, 173]
first 8 CORRECT type4 rows:
  [0, 4, 7, 38, 39, 40, 41, 108, 109, 172, 177, 201, 1]
  [1, 1, 1, 1, 1, 1, 1, 1, 1, 1, 1, 1, 1]
  [1, 1, 1, 1, 1, 1, 1, 1, 1, 1, 1, 1, 1]
  [1, 1, 1, 1, 1, 1, 1, 1, 1, 1, 1, 1, 1]
  [1, 1, 1, 1, 1, 1, 1, 1, 1, 1, 1, 1, 1]
  [1, 1, 1, 1, 1, 1, 1, 1, 1, 1, 1, 1, 1]
  [1, 1, 1, 1, 1, 1, 1, 1, 1, 1, 1, 1, 1]
  [1, 1, 1, 1, 1, 1, 1, 1, 1, 1, 1, 1, 1]

LEV5MAP header: field/width=13, block/height=288, decoded=3744
first 8 WRONG direct rows:
  [0, 1, 1, 1, 1, 1, 1, 1, 1, 1, 1, 1, 1]
  [1, 1, 1, 1, 1, 88, 198, 178, 82, 1, 1, 235, 1]
  [1, 235, 171, 165, 69, 48, 46, 69, 161, 169, 1, 1, 1]
  [1, 1, 233, 1, 1, 233, 1, 1, 171, 165, 49, 47, 68]
  [163, 175, 175, 175, 175, 165, 65, 48, 46, 66, 48, 46, 67]
  [161, 169, 173, 1, 1, 1, 133, 125, 124, 126, 1, 1, 190]
  [148, 189, 1, 1, 1, 1, 1, 1, 1, 1, 1, 1, 171]
  [167, 69, 57, 55, 64, 65, 84, 82, 11, 8, 4, 2, 1]
first 8 CORRECT type4 rows:
  [0, 1, 1, 1, 1, 1, 1, 1, 1, 1, 1, 1, 1]
  [1, 1, 1, 1, 1, 1, 1, 1, 1, 1, 1, 1, 1]
  [1, 1, 1, 1, 1, 1, 1, 1, 1, 1, 1, 1, 1]
  [1, 1, 1, 1, 1, 1, 1, 1, 1, 1, 1, 1, 1]
  [1, 1, 1, 1, 1, 1, 1, 1, 1, 1, 1, 1, 1]
  [1, 1, 1, 1, 1, 1, 1, 1, 1, 1, 1, 1, 1]
  [1, 1, 1, 1, 1, 1, 1, 1, 1, 1, 1, 1, 1]
  [1, 1, 1, 1, 1, 1, 1, 1, 1, 1, 1, 1, 1]

